11111111111111111111111111111111
1001C000000000000000000000000011
100100000100000010001C0000000101
100100N0001000001010001000001001
10010000000100001000000100010001
100100000000100000000N0000100001
100000000000010000000C0001000001
1000000C000000100000000010000001
10000000000000010000000100E00001
100100000N0000000000000000000001
10010000000000000100010000000001
1001000C000000000010100000000001
10010000000000000001N00000C00001
10000000000000000000100000000001
10000000000000000010001000000001
10010000C00000001000000100000001
10010000000000100000000010P00001
11111111111111111111111111111111
